# # # # # # # # # # # B # # # # # # # # # # # B B
# 0 0 0 B B 0 0 0 0 0 B 0 0 0 0 0 B B 0 0 0 0 B B
# 0 0 0 B B 0 0 0 0 0 B 0 0 0 0 0 B B 0 0 0 0 B B
# B B B B B 0 0 0 0 0 B 0 0 0 0 0 B B 0 0 0 0 B B
# 0 0 0 0 0 0 0 0 0 0 B B B 0 0 0 0 0 0 0 0 0 # B
# 0 0 0 0 0 0 0 0 0 0 0 0 B 0 0 0 0 0 0 0 0 0 0 #
B B B B B B B 0 0 0 0 0 0 B 0 0 0 0 0 0 0 0 0 0 #
# 0 0 B 0 0 0 0 0 0 B B B B 0 0 0 0 0 B B B B B B
# 0 0 B 0 0 0 0 0 0 0 0 0 0 0 0 0 0 0 B 0 0 0 B #
# 0 0 B 0 0 0 0 0 0 0 0 0 0 0 0 0 0 0 B 0 0 0 B #
# 0 0 B 0 0 0 0 0 0 B B B B B B B B B B 0 0 0 0 #
# 0 0 B 0 0 0 0 0 0 B B B B B B B B B B 0 0 0 0 #
# 0 0 B B B 0 0 0 0 0 0 0 0 0 0 0 0 0 B 0 0 0 0 #
# 0 0 0 0 0 0 0 0 0 0 0 0 0 0 0 0 0 0 0 0 0 0 0 #
# 0 0 0 0 0 0 0 0 0 0 0 0 0 0 0 0 0 0 0 0 0 0 0 #
# 0 0 0 0 0 0 0 Y 0 B B B B 0 G 0 0 0 0 0 0 0 0 #
# 0 0 0 0 0 0 0 0 0 B F F B 0 0 0 0 0 0 0 0 0 0 #
# # # # # # # # # # B F F B # # # # # # # # # # #
