# # # # B # # # # # # B # # # # # # B # # # # B B
# 0 E 0 B B 0 0 0 0 0 B 0 0 0 0 0 B B 0 0 0 0 B B
# 0 0 0 B B E 0 0 0 0 B 0 0 0 0 0 B B 0 0 0 0 B B
B B B B B B 0 0 0 0 0 B 0 0 0 0 0 B B 0 0 0 0 B B
# 0 B 0 0 0 0 0 0 0 0 B B B 0 0 0 0 0 B 0 0 0 # B
# 0 0 0 0 0 0 0 0 0 0 0 0 B 0 0 0 0 0 0 0 0 0 0 #
B B B B B B B 0 0 0 0 0 0 B 0 0 0 0 0 0 0 0 0 0 #
# 0 0 B 0 0 0 0 0 0 B B B B 0 0 0 0 0 B 0 0 0 B B
# 0 0 B 0 0 0 0 0 0 0 0 0 0 0 0 0 0 0 B 0 0 0 B #
# 0 0 B 0 0 0 0 0 0 0 0 0 0 0 0 0 0 0 B B B B B #
# 0 0 B 0 0 0 0 0 0 B B B W B B B B B B 0 0 0 0 #
# 0 0 B 0 0 0 0 0 0 B B B W W W W W W W 0 0 0 0 #
# 0 0 B W B 0 0 0 0 0 0 0 0 0 0 0 0 0 B 0 0 0 0 #
# 0 0 0 0 0 0 0 0 0 B B B 0 0 0 0 0 0 B 0 0 0 0 #
# 0 0 0 0 0 0 0 0 0 B Y B 0 0 0 0 0 0 B 0 0 0 0 #
# 0 0 0 0 0 0 0 0 0 B B B B 0 G 0 0 0 B 0 0 E 0 #
# 0 0 0 0 0 0 0 0 0 B F F B 0 0 0 0 0 B 0 0 0 0 #
# # # # # # # # # # B F F B # # # # # B # # # # #
